NO   textures/no2.png
WE   textures/no2.png
SO   01 .png

EA   textures/wall2.png
F   123, 54, 12
C	1, 1, 1
111
11111111111111111
10000000000000001
1N000000000000001
11111111111111111