NO textures/wall2.png
SO textures/wall2.png
WE textures/wall2.png
EA textures/wall2.png


F 164,169,20
C 153,204,255,7

   111
111111111111111111111
101000001000000000001
101010101011111110001
10001010001000001000111
111110101111101011101
100000101000101000001
101111101011101111111
101000001010100000101
10101111101011111010111111
101010001010100010101
101110101010101010101
100000101010001010001
111111101011111011101
100000101000100010001
101110101110101110111
101000100000100010101
101011111111111010101
100010000000000010001
101010111011111111101
1N1000001000000100001
111111111111111111111