F 139,99,58
C 171,154,137

NO textures/wall2.png
SO textures/wall2.png
WE textures/wall2.png
EA textures/wall2.png

1111111111111111111
1001001001001001001
1001001001001001001
1001001001001001001
1001001000001001001
1000000000000000001
1000011111111000001
1111000000000001111
10000001010100000N1
1111111111111111111


