F 216,187,255
C 38,16,87

NO textures/100_1453_seamless.png
SO textures/100_1453_seamless.png
WE textures/100_1453_seamless.png
EA textures/100_1453_seamless.png

1111111111111111111
10010010010S1001001
1001001001001001001
1001001001001001001
1001001001000001001
1000000000000000001
1000011111111000001
1111000000000001111
1000000101010000001
1111111111111111111


