F 139,99,58
C 171,154,137

NO textures/wall2.png
SO textures/wall2.png
WE textures/wall2.png
EA textures/wall2.png

111111111111111
100001000001001
101101011101011
100100000100001
110111110111101
100000010000101
101111011110101
101000000010001
101011111011111
100010001000001
111110101111101
100000100000101
101111111110101
1000000000001N1
111111111111111

